SSSSSSSSSSSSSSSSSSSSSSSSSSSSSSSSSSSSSSSSSSSSSSSSSSSSSSN
SSSSSSSSSSSSSSSSSSSSSSSSSSSSSSSSSSSSSSSSSSSSSSSSSSSSSSN
SSSSSSSSSSSSSSSSSSSSSSSSSSSSSSSSSSSSSSSSSSSSSSSSSSSSSSN
SSSSSSSSSSSSSSSSSSSSSSSSSSSSSSSSSSSSSSSSSSSSSSSSSSSSSSN
SSSSSSSSSSSSSSBBSSSSSSSSSSSSSSSSSSSSSSSSSSSSSSSSSSSSSSN
SSSSSSSSSSSSSSSSSSSSSSSSSSSSSSSSSSSSSSSSSSSSSSSSGSSSSSN
SSSSSSSSSSBBSSSSSSBBBBBWWBBBWWBBBWWBBBWWBBBBBBBBBBBBBBN
SSSSSSSSSSSSSSSSSSBBBBBBBBBBBBBBBBBBBBBBBBBBBBBBBBBBBBN
SSSSSSBBSSSSSSSSSSBBBBBBBBBBBBBBBBBBBBBBBBBBBBBBBBBBBBN
SSSSSSSSSSSSSSSSSSBBBBBBBBBBBBBBBBBBBBBBBBBBBBBBBBBBBBN
BBBBBBBBBBBBBBBBBBBBBBBBBBBBBBBBBBBBBBBBBBBBBBBBBBBBBBN
BBBBBBBBBBBBBBBBBBBBBBBBBBBBBBBBBBBBBBBBBBBBBBBBBBBBBBN
BBBBBBBBBBBBBBBBBBBBBBBBBBBBBBBBBBBBBBBBBBBBBBBBBBBBBBN