SSSSSSSSSSSSSSSSSSSSSSSSSSSSS
SSSSSSSSSSSSSSSSSSSSSSSSSSSSS
SSSSSSSSSSSSSSSSSSSSSSSSSSSSS
SSSSSSSSSSSSSSSSSSSSSKSSSSSSS
SSSSSSBBSSSSSSSSSSBBBBBBBSSSS
SSSSSSSSSSSSSSSSSSSSSSSSSSSSS
SSSSSSSSSSSSSBBSSSSSSSSSSBBSS
SSSSSSSSSSSSSSSSSSSSSSSSSSSSS
SSSSSSSBBSSSSSSSSSSSSSBBSSSSS
SSSSSSSSSSSSSSSSSSSSSSSSSSSSS
SSSBBSSSSSSSSSSSSBBSSSSSSSSSS
SSSSSSSSSSSSSSSSSSSSSSSSSSSSS
SSSSSSSBBSSSSBBSSSSSSSSSSSSSS
SSSSSSSSSSSSSSSSSSSSSSSSSSSSS
SSSSSSSSSSBBSSSSSSSSSSSSSSSSS
SSSSSSSSSSSSSSBBSSSSSSSSSSSSS
SSSSSSSSSSSSSSSSSSSSSSSSSBBSS
SSSSSSSSSSSBBSSSSSSSSSSSSSSSS
SSSSSSSSBBSSSSSSSSSBBBBBBBBBB
SSSSSBBSSSSSSSSSSSSDSSSSSSSSS
SSSSSSSSSSSSSSSSSSSDSSSGSSSSS
BBBBBBBBBBBBBBBBBBBBBBBBBBBBB
BBBBBBBBBBBBBBBBBBBBBBBBBBBBB