SSSSSSSSSSSSSSSSSSSS
SSSSSSSSSSSSSSSSSSSS
SSSSSSSSSSSSSSSSSSSS
SSSSSSSSSBBSSSSSSSSS
SSSSSSSSSSSSSSSSSSSS
SSSSSSSSSSSSSSBBSSSS
SSSSSSBBSSSSSSSSSSSS
SSSSSSSSSSSSSSSSSSSS
SSSSSSSSSSSSSBBSSSSS
SSSSSSSSSSSSSSSSSSSS
BBBBBBBBBBBBBBBBBBBB
BBBBBBBBBBBBBBBBBBBB
BBBBBBBBBBBBBBBBBBBB