SSSSSSSSSSSSSSSSSSSS
SSSSSSSSSSSSSSSSSSSS
SSSSSSSSSSSSSSSSSSSS
SSSSSBBBSSSSSSSSSSSB
SSSSSSSSSSSSSSSSSSSS
SSSSSSSSSSSSBBBBSSSS
SSSSSSSSSSSSSSSSSSSS
SSSSSSBBBBSSSSSSSSSS
SSSSSSSSSSSSSSSSSSSS
SSSSSSSSSSSSSSSSSSSS
BBBBBBBBBBBBBBBBBBBB
BBBBBBBBBBBBBBBBBBBB
BBBBBBBBBBBBBBBBBBBB