SSSSSSSSSSSSSSSSSSSSSSSSSSSSSSSSSSSSSSSSSSSSSSSSN
SSSSSSSSSSSSSSSSSSSSSSSSSSSSSSSSSSSSSSSSSBBBBBBBN
SSSSSSSSSSSSSSSSSSSSSSSSSSSSSSSSSSSSSSSSSBSSSSSSN
SSSSSSSSSSSSSSSSSSSSSSSSSSSSSSSSSSSBBBBBBBSSSSSSN
SSSSSSSSSSSSSSSSSSSSSSSSSSCSSSSSSSSBSSSSSBSSSSGSN
SSSSSSSSSSSSSSBBBSBBBSSSSSSSSSSSSSSBSSSSSBSSBBBSN
SSSSSSSSSSSSSSSSSKSSBSSSSSSSSCCCSSSBSSSSSDSBBBBSN
SSSSSSSSSSSSSSBSSSSSBSSSSSSSSSSSSSSBSSSSBBBBBBBSN
SSSSSSSSSSSSSSBBBBBBBSSSSCCSSSSSSSSBSSBBBBBBBBBSN
SSSSSSSSSMSSSSSSSSSSSSSSSSSSSMSSSSSBBSSSSSSSSSSSN
SISSSSSSSSSSSSSSSSSSSSSSSSSSSSSSSSSDSSSSSSSSSSKSN
BBBBBBBBBBBBBBBBBBBWWWWWWBBBBBBBBBBBBBBBBLLLBBBBN
BBBBBBBBBBBBBBBBBBBBBBBBBBBBBBBBBBBBBBBBBBBBBBBBN
