SSSSSSSSSSSSSSSSSSSSSSSSSSSSSSSSSSSSSSSSSSSSPSSSN
SSSSSSSSSSSSSSSSSSSSSSSSSSSSSSSSSSSSSSSSSBBBBBBBN
SSSSSSSSSSSSSSSSSSSSSSSSSSSSSSSSSSSSPSPSSBSSSSSSN
SSSSSSSSSSSSSSSSSSSSSSSSSSSSSSSSSSSBBBBBBBSSSSSSN
SSSSSSSSSSSSSSSSSSSPSSSSSSBSSSSSSSSBSSSSSBSSPSGSN
SSSSSSSSSSSSSSBBBSBBBSSSSSSSSSPSSSSBSSSSSBSSBBBSN
SSSSSSSSSSSSSSSSSKSSBSSSSSSSSBBBSSSBSSSSSDSBBBBSN
SSSSSSSSSSSSSSBSPSSSBSSSSSSSSSSSSSSBSSSSBBBBBBBSN
SSSSSSSSSSSSSSBBBBBBBSSSSBBSSSSSSSSBSSBBBBBBBBBSN
SSSSSSSSSMSSSSSSSSSSSSSSSSSSSMSSSSSBBSSSSSSSSSSSN
SISSPSSSSSSPSSSPSSSSSSSSSSSPSSSSPSSDSSSPSSSSSPKSN
BBBBBBBBBBBBBBBBBBBWWWWWWBBBBBBBBBBBBBBBBLLLBBBBN
BBBBBBBBBBBBBBBBBBBBBBBBBBBBBBBBBBBBBBBBBBBBBBBBN
