SSSSSSSSSSSSSSSSSSSSSSSSSSSSSN
SSSSSSSSSSSSSSSSSSSSSSSSSSSSSN
SSSSSSSSSSSSSSSSSSSSSSSSSSSSSN
SSSSSSSSSSSSSSSSSSSSSKSSSSSSSN
SSSSSSBBSSSSSSSSSSBBBBBBBSSSSN
SSSSSSSSSSSSSSSSSSSSSSSSSSSSSN
SSSSSSSSSSSSSBBSSSSSSSSSSBBSSN
SSSSSSSSSSSSSSSSSSSSSSSSSSSSSN
SSSSSSSBBSSSSSSSSSSSSSBBSSSSSN
SSSSSSSSSSSSSSSSSSSSSSSSSSSSSN
SSSBBSSSSSSSSSSSSBBSSSSSSSSSSN
SSSSSSSSSSSSSSSSSSSSSSSSSSSSSN
SSSSSSSBBSSSSBBSSSSSSSSSSSSSSN
SSSSSSSSSSSSSSSSSSSSSSSSSSSSSN
SSSSSSSSSSBBSSSSSSSSSSSSSSSSSN
SSSSSSSSSSSSSSBBSSSSSSSSSSSSSN
SSSSSSSSSSSSSSSSSSSSSSSSSBBSSN
SSSSSSSSSSSBBSSSSSSSSSSSSSSSSN
SSSSSSSSBBSSSSSSSSSBBBBBBBBBBN
SSSSSBBSSSSSSSSSSSSDSSSSSSSSSN
SISSSSSSSSSSSSSSSSSDSSSGSSSSSN
BBBBBBBBBBBBBBBBBBBBBBBBBBBBBN
BBBBBBBBBBBBBBBBBBBBBBBBBBBBBN