SSSSSSSSSSSSSSSSSSSSSSSSSSSSSSSSSSSSSSSSSSSSSSSSSSSSSSN
SSSSSSSSSSSSSSSSSSSSSSSSSSSSSSSSSSSSSSSSSSSSSSSSSSSSSSN
SSSSSSSSSSSSSSSSSSSSSSSSSSSSSSSSSSSSSSSSSSSSSSSSSSSSSSN
SSSSSSSSSSSSSSSSSSSSSSSSSSSSSSSSSSSSSSSSSSSSSSSSSSSSSSN
SSSSSSSSSSSSSSBBSSSMSSSSSSSSSSSMSSSSSSSSSSMSSSSSSSSSSSN
SSSSSSSSSSSSSSSSSSSSSPSSSSSSSSSSSSSSPSSSSSSPSSSSGSSPSSN
SSSSSSSSSSBBSSSSSSBBBBBWWBBBWWBBBWWBBBWWBBBBBBBBBBBBBBN
SSSSSSSSSSSSSSSSSSBBBBBBBBBBBBBBBBBBBBBBBBBBBBBBBBBBBBN
SSSSSSBBSSSSSSSSSSBBBBBBBBBBBBBBBBBBBBBBBBBBBBBBBBBBBBN
SIPSSSSMSPSSSSPSSSBBBBBBBBBBBBBBBBBBBBBBBBBBBBBBBBBBBBN
BBBBBBBBBBBBBBBBBBBBBBBBBBBBBBBBBBBBBBBBBBBBBBBBBBBBBBN
BBBBBBBBBBBBBBBBBBBBBBBBBBBBBBBBBBBBBBBBBBBBBBBBBBBBBBN
BBBBBBBBBBBBBBBBBBBBBBBBBBBBBBBBBBBBBBBBBBBBBBBBBBBBBBN