SSSSSSSSSSSSSSSSSSSSN
SSSSSSSSSSSSSSSSSSSSN
SSSSSSSSSSSSSSSSSSSSN
SSSSSBBBSSSSSSSSSSSBN
SSSSSSSSSSSSSSSSSSSSN
SSSSSSSSSSSSBBBBSSSSN
SSSSSSSSSSSSSSSSSSSSN
SSSSSSBBBBSSSSSSSSSSN
SSSSSSSSSSSSSSSSSSSSN
SSSSSSSSSSSSSSSSSSSSN
BBBBBBBBBBBBBBBBBBBBN
BBBBBBBBBBBBBBBBBBBBN
BBBBBBBBBBBBBBBBBBBBN