BBBBBBBBBBBBBBBBBBBBBBBBBBBBBBBBBBBBBBBBBBBBBBBBBBBBBBBBBBBBBBBBBBBBBBBBBBBBBN
BBBBBBBBBBBBBBBBBBBBBBBBBBBBBBBBBBBBBBBBBBBBBBBBBBBBBBBBBSSSSSSSSSSSSSSSSSSSSN
BBBBBBBBBBBBBBBBBBBBBBBBBBBBBBBBBBBBBBBBBBBBBBBBBBBBBBBBBSSSSSSSSSSSSSSSSSSSSN
BBBBBBBBBBBBBBBBBBBBBBBBBBBBBBBBBBBBBBBBBBBBBBBBBBBBBBBBBSSSSSSSSSSSSSSSSGSSSN
BSSSSSSSSSSSSSSSSSSSSSSSSSSSSSSSSSSSSSSSSSSSSSSSSSBBBBBBBSSSSSSSSSSSBBBBBBBBBN
BSKSSSSSSSSSSSSSSSSSSSSSSSSSSSSSSSSSSSSSSSSSSSSSSSBBBBBBBSSSSSSSSBBBBBBBBBBBBN
BSSSSSSSSSSSSSSSSSSSSSSSSSSSSSSSSSSSSSSSSSSSSSSSSSBBBBBBBBBSSSBBBBBBBBBBBBBBBN
BBBSBSSSSSSSSSSSSSSSSSSSSSSSMSSSSSSSSSSSSSSSSSSSSSSSSSSSSSSSSSSSSSSSASSSSMSSBN
BSSSSSBSSBSSSBMBSSSBSSSBSSSSSSSSSSSSSSSSSSSSSSSSSSSSSSSSSSBBBSBSSSSSSSSSSSSBBN
BSSSSSSSSSSSSSSSSSSSSSSSSSSBBBSSSSSSSSSSSSSSSSSSSSSSSSSSSSSSSSBBBBSSSSSSSBBBBN
BSSSSSSSSSSSSSSSSASSSSSSSSSSSSSSBSSSBSSSBSSSSSSSSSSSSSSSSSSSSSBSSSSSBSSSSBBBBN
BSISSSSSSSSSSSSSSSSSSSSSSSSSSSSSSSSSSSSSSSSSSSSSSSSSSSSSSSSSSSDSSSSSSSSBBBBBBN
BBBBBBBBBBBBBBBBBBBBBBBBBBBBBBBBBBBBBBBBBBBBBBBBBBBBBBBBBBBBBBBBBBBBBBBBBBBBBN
BBBBBBBBBBBBBBBBBBBBBBBBBBBBBBBBBBBBBBBBBBBBBBBBBBBBBBBBBBBBBBBBBBBBBBBBBBBBBN