SSSSSSSSSSSSSSSSSSSSSSSSSSSSSSSSSSSSSSSSSSSSSSSSSSSSSSN
SSSSSSSSSSSSSSSSSSSSSSSSSSSSSSSSSSSSSSSSSSSSSSSSSSSSSSN
SSSSSSSSSSSSSSSSSSSSSSSSSSSSSSSSSSSSSSSSSSSSSSSSSSSSSSN
SSSSSSSSSSSSSSSSSSSSSSSSSSSSSSSSSSSSSSSSSSSSSSSSSSSSSSN
SSSSSSSSSSSSSSBBSSSMSSSSSSSSSSSMSSSSSSSSSSMSSSSSSSSSSSN
SSSSSSSSSSSSSSSSSSSSSSSSSSSSSSSSSSSSSSSSSSSSSSSSGSSSSSN
SSSSSSSSSSBBSSSSSSBBBBBWWBBBWWBBBWWBBBWWBBBBBBBBBBBBBBN
SSSSSSSSSSSSSSSSSSBBBBBBBBBBBBBBBBBBBBBBBBBBBBBBBBBBBBN
SSSSSSBBSSSSSSSSSSBBBBBBBBBBBBBBBBBBBBBBBBBBBBBBBBBBBBN
SISSSSSMSSSSKSSSSSBBBBBBBBBBBBBBBBBBBBBBBBBBBBBBBBBBBBN
BBBBBBBBBBBBBBBBBBBBBBBBBBBBBBBBBBBBBBBBBBBBBBBBBBBBBBN
BBBBBBBBBBBBBBBBBBBBBBBBBBBBBBBBBBBBBBBBBBBBBBBBBBBBBBN
BBBBBBBBBBBBBBBBBBBBBBBBBBBBBBBBBBBBBBBBBBBBBBBBBBBBBBN