SSSSSSSSSSSSSSSSSSSSSSSSSSSSSSSSSSSSSSSSSSSSSSSSN
SSSSSSSSSSSSSSSSSSSSSSSSSSSSSSSSSSSSSSSSSSSSSSSSN
SSSSSSSSSSSSSSSSSSSSSSSSSSSSSSSSSSSSSSSSSSSSSSSSN
SSSSSSSSSSSSSSSSSSSSSSSSSSSSSSSSSSSBBBBBBBBBBBBSN
SSSSSSSSSSSSSSSSSSSSSSSSSSCSSSSSSSSBSSSSSSSSSSGSN
SSSSSSSSSSSSSSBBBBBBBSSSSSSSSSSSSSSBSSSSSSSSBBBSN
SSSSSSSSSSSSSSSSSKSSBSSSSSSSSCCCSSSBSSSSSSSBBBBSN
SSSSSSSSSSSSSSBSSSSSBSSSSSSSSSSSSSSBSSSSBBBBBBBSN
SSSSSSSSSSSSSSBBBBBBBSSSSCCSSSSSSSSBSSBBBBBBBBBSN
SSSSSSSSSSSSSSSSSSSSSSSSSSSSSSSSSSSBBSSSSSSSSSSSN
SSSSSSSSSSSSSSSSSSSSSSSSSSSSSSSSSSSDSSSSSSSSSSKSN
BBBBBBBBBBBBBBBBBBBWWWWWWBBBBBBBBBBBBBBBBLLLBBBBN
BBBBBBBBBBBBBBBBBBBBBBBBBBBBBBBBBBBBBBBBBBBBBBBBN
