SSSSSSSSSSSSSSSSSSSSSSSSSSSSSSSSSSSSSSSSSSSSSSSSSSSSSSSSSSSSN
SSSSSSSSSSSSSSSSSSSSSSSSSSSSSSSSSSSSSSSSSSSSSSSSSSSSSSSSSSSSN
SSSSSSSSSSSSSSSSSSSSSSSSSSSSSSSSSSSSSSSSSSSSSSSSSSSSSSSSSSSSN
SSSSSSSSSSSSSSSSSSSSSSSSSSSSSSSSSSSSSSSSSSSSSSSSSSSSSSSSSSSSN
SSSSSSSSSSSSSSSSSSSSSSSSSSSSSSSSSSSSSSSSSSSSSSSSSSSSSSSSSSSSN
SSSSSSSSSSSSSSSSSSSSSSSSSSSSSSSSSSSSSSSSSSSSSSSSSSSSSSSSSSSSN
SSSSSSSSSSSSSSSSSSSSSSSSSBBSSSSBBSSSSBBSSSSBBSSSSSSSSSSSSSSSN
SSSSSSSSSSSSSSSSSSSSSSSSSSSSSSSSSSSSSSSSSSSSSSSSSSSSSSGSSSSSN
SSSSSSSSSSSSSSSSSSBBBBBBSSSSSSSSSSSSSSSSSSSSSSBBBBBBBBBBBBBBN
SSSSSSSSSSSSSSSSBBBBBBBBSSSSSSSSSSSSSSSSSSSSSSBBBBBBBBBBBBBBN
BBBBBBBWWWWBBBBBBBBBBBBBSSSSSSSSSSSSSSSSSSSSSSBBBBBBBBBBBBBBN
BBBBBBBBBBBBBBBBBBBBBBBBWWWWWWWWWWWWWWWWWWWWWWBBBBBBBBBBBBBBN
BBBBBBBBBBBBBBBBBBBBBBBBBBBBBBBBBBBBBBBBBBBBBBBBBBBBBBBBBBBBN