SSSSSSSSSSSSSSSSSSSSSSSSSSSSSSSSSSSSSSSSSSSSSSSSSSSSSSSSSSSSN
SSSSSSSSSSSSSSSSSSSSSSSSSSSSSSSSSSSSSSSSSSSSSSSSSSSSSSSSSSSSN
SSSSSSSSSSSSSSSSSSSSSSSSSSSSSSSSSSSSSSSSSSSSSSSSSSSSSSSSSSSSN
SSSSSSSSSSSSSSSSSSSSSSSSSSSSSSSSSSSSSSSSSSSSSSSSSSSSSSSSSSSSN
SSSSSSSSSSSSSSSSSSSSSSSSSSSSSSSSSSSSSSSSSSSSSSSSSSSSSSSSSSSSN
SSSSSSSSSSSSSSSSSSSSSSSSSSSSSSSASSSSSSSSSSSSSSSSSSSSSSSSSSSSN
SSSSSSSSSSSSSSSSSSSSSMSSSBBSSSSBBSSSSBBSSSSBBSSSSSSSSSSSSSSSN
SSSSSSSSSSSSSSSSSSSSSPSSSSSSSSSSSSSSSSSSSSSSSSSPSMSPSSGSSPSSN
SSSSSSSSSSSSSSSSSSBBBBBBSSSSSSSSSSSSSSSSSSSSSSBBBBBBBBBBBBBBN
SISPSSMSSSSSPSSSBBBBBBBBSSSSSSSSSSSSSSSSSSSSSSBBBBBBBBBBBBBBN
BBBBBBBWWWWBBSSSDSMSSSKSSSSSSSSSSSSSSSSSSSSSSSBBBBBBBBBBBBBBN
BBBBBBBBBBBBBBBBBBBBBBBBWWWWWWWWWWWWWWWWWWWWWWBBBBBBBBBBBBBBN
BBBBBBBBBBBBBBBBBBBBBBBBBBBBBBBBBBBBBBBBBBBBBBBBBBBBBBBBBBBBN