SSSSSSSSSSSSSSSSSSSSSSSSSSSSSSSSSSSSSSSSSSSSSSSSSSSSSSSSSSSSN
SSSSSSSSSSSSSSSSSSSSSSSSSSSSSSSSSSSSSSSSSSSSSSSSSSSSSSSSSSSSN
SSSSSSSSSSSSSSSSSSSSSSSSSSSSSSSSSSSSSSSSSSSSSSSSSSSSSSSSSSSSN
SSSSSSSSSSSSSSSSSSSSSSSSSSSSSSSSSSSSSSSSSSSSSSSSSSSSSSSSSSSSN
SSSSSSSSSSSSSSSSSSSSSSSSSSSSSSSSSSSSSSSSSSSSSSSSSSSSSSSSSSSSN
SSSSSSSSSSSSSSSSSSSSSSSSSSSSSSSASSSSSSSSSSSSSSSSSSSSSSSSSSSSN
SSSSSSSSSSSSSSSSSSSMSSSSSBBSSSSBBSSSSBBSSSSBBSSSSMSSSSSSSSSSN
SSSSSSSSSSSSSSSSSSSSSPSSSSSSSSSSSSSSSSSSSSSSSSSPSSSPSSGSSPSSN
SSSSSSMSSSSSSSSSSSBBBBBBSSSSSSSSSSSSSSSSSSSSSSBBBBBBBBBBBBBBN
SISPSSSSSSSSSPSSBBBBBBBBSSSSSSSSSSSSSSSSSSSSSSBBBBBBBBBBBBBBN
BBBBBBBWWWWBBBBSDSSSSSKSSSSSSSSSSSSSSSSSSSSSSSBBBBBBBBBBBBBBN
BBBBBBBBBBBBBBBBBBBBBBBBWWWWWWWWWWWWWWWWWWWWWWBBBBBBBBBBBBBBN
BBBBBBBBBBBBBBBBBBBBBBBBBBBBBBBBBBBBBBBBBBBBBBBBBBBBBBBBBBBBN