SSSSSSSSSSSSSSSSSSSSSSSSSSSSSSSSSSSSSSSSSSSSSSSSSSSSSSN
SSSSSSSSSSSSSSSSSSSSSSSSSSSSSSSSSSSSSSSSSSSSSSSSSSSSSSN
SSSSSSSSSSSSSSSSSSSSSSSSSSSSSSSSSSSSSSSSSSSSSSSSSSSSSSN
SSSSSSSSSSSSSSSSSSSSSSSSSSSSSSSSSSSSSSSSSSSSSSSSSSSSSSN
SSSSSSSSSSSSSSBBSSSSSSSSSSSSSSSSSSSSSSSSSSSMSSSSSSSSSSN
SSSSSSSSSSSSSSSSSSSMSPSSSSSSSSSMSSSSPSSSSSSPSSSSGSSPSSN
SSSSSSSSSSBBSSSSSSBBBBBWWBBBWWBBBWWBBBWWBBBBBBBBBBBBBBN
SSSSSSSSSSSSSSSSSSBBBBBBBBBBBBBBBBBBBBBBBBBBBBBBBBBBBBN
SSSSSSBBSSSSSSSSSSBBBBBBBBBBBBBBBBBBBBBBBBBBBBBBBBBBBBN
SIPSSSSMSPSSSSPSSSBBBBBBBBBBBBBBBBBBBBBBBBBBBBBBBBBBBBN
BBBBBBBBBBBBBBBBBBBBBBBBBBBBBBBBBBBBBBBBBBBBBBBBBBBBBBN
BBBBBBBBBBBBBBBBBBBBBBBBBBBBBBBBBBBBBBBBBBBBBBBBBBBBBBN
BBBBBBBBBBBBBBBBBBBBBBBBBBBBBBBBBBBBBBBBBBBBBBBBBBBBBBN