BBBBBBBBBBBBBBBBBBBBBBBBBBBBBBBBBBBBBBBBBBBBBBBBBBBBBBBBBBBBBBBBBBBBBBBBBBBBBN
BBBBBBBBBBBBBBBBBBBBBBBBBBBBBBBBBBBBBBBBBBBBBBBBBBBBBBBBBSSSSSSSSSSSSSSSSSSSSN
BBBBBBBBBBBBBBBBBBBBBBBBBBBBBBBBBBBBBBBBBBBBBBBBBBBBBBBBBSSSSSSSSSSSSSSSSSSSSN
BBBBBBBBBBBBBBBBBBBBBBBBBBBBBBBBBBBBBBBBBBBBBBBBBBBBBBBBBSSSSSSSSSSSPSSSSGSPSN
BSSSSSSSSSSSSSSSSSSSSSSSSSSSSSSSSSSSSSSSSSSSSSSSSSBBBBBBBSSSSSSSSSSSBBBBBBBBBN
BSKSSSSSSSSSSSSSSSSSSSSSSSSSSSSSSSSSSSSSSSSSSSSSSSBBBBBBBSSSSSSPSBBBBBBBBBBBBN
BSSSPSSSSSSSSSSSSSSSSSSSSSSSSSSSSSSSSSSSSSSSSSSSSSBBBBBBBBBSSSBBBBBBBBBBBBBBBN
BBBSBSSSSSSSSMSSSSSPSSSSSSSSSSSSSSSSSSSSSSSSSSSSSSSSSSSSSSSPSSSSSSSSASSSSMSSBN
BSSSSSBSSBSSSBSBSSSBSSSBSSSSMSSSSSSSSSSSSSSSSSSSSSSSSSSSSSBBBSBSPSSSSSSSSPSBBN
BSSSSSSSSSSSSSSSSSSSSSSSSSSBBBSSPSSSSSSSSSSSSSSSSSSSSSSSSSSSSSBBBBSSSSSSSBBBBN
BSSSSSSSSSSSSSSSSASSSSSSSSSSSSSSBSSSBSSSBSSSSSSSSSSSSSSSSSSSSSBSSSSSBSSSSBBBBN
BSISSPSSSSSSSSSSPSSSPSSSSSSPSSSSSSSSSPSSSPSSSSSSSPSSSSSPSSSSSSDSSPSSSSSBBBBBBN
BBBBBBBBBBBBBBBBBBBBBBBBBBBBBBBBBBBBBBBBBBBBBBBBBBBBBBBBBBBBBBBBBBBBBBBBBBBBBN
BBBBBBBBBBBBBBBBBBBBBBBBBBBBBBBBBBBBBBBBBBBBBBBBBBBBBBBBBBBBBBBBBBBBBBBBBBBBBN