SSSSSSSSSSSSSSSSSSSSSSSSSSSSSSSSSSSSSSSSSSSSSSSSSSSSSSSSSSSSN
SSSSSSSSSSSSSSSSSSSSSSSSSSSSSSSSSSSSSSSSSSSSSSSSSSSSSSSSSSSSN
SSSSSSSSSSSSSSSSSSSSSSSSSSSSSSSSSSSSSSSSSSSSSSSSSSSSSSSSSSSSN
SSSSSSSSSSSSSSSSSSSSSSSSSSSSSSSSSSSSSSSSSSSSSSSSSSSSSSSSSSSSN
SSSSSSSSSSSSSSSSSSSSSSSSSSSSSSSSSSSSSSSSSSSSSSSSSSSSSSSSSSSSN
SSSSSSSSSSSSSSSSSSSSSSSSSSSSSSSASSSSSSSSSSSSSSSSSSSSSSSSSSSSN
SSSSSSSSSSSSSSSSSSSMSSSSSBBSSSSBBSSSSBBSSSSBBSSSSMSSSSSSSSSSN
SSSSSSSSSSSSSSSSSSSSSSSSSSSSSSSSSSSSSSSSSSSSSSSSSSSSSSGSSSSSN
SSSSSSMSSSSSSSSSSSBBBBBBSSSSSSSSSSSSSSSSSSSSSSBBBBBBBBBBBBBBN
SISSSSSSSSSSSSSSBBBBBBBBSSSSSSSSSSSSSSSSSSSSSSBBBBBBBBBBBBBBN
BBBBBBBWWWWBBBBSDSSSSSKSSSSSSSSSSSSSSSSSSSSSSSBBBBBBBBBBBBBBN
BBBBBBBBBBBBBBBBBBBBBBBBWWWWWWWWWWWWWWWWWWWWWWBBBBBBBBBBBBBBN
BBBBBBBBBBBBBBBBBBBBBBBBBBBBBBBBBBBBBBBBBBBBBBBBBBBBBBBBBBBBN