SSSSSSSSSSSSSSSSSSSSSSSSSSSSSSSSSSSSSSSSSSSSPSSSN
SSSSSSSSSSSSSSSSSSSSSSSSSSSSSSSSSSSSSSSSSBBBBBBBN
SSSSSSSSSSSSSSSSSSSSSSSSSSSSSSSSSSSMPSPSSBSSSSSSN
SSSSSSSSSSSSSSSSSSSMSSSSSSSSSSSSSSSBBBBBBBSSSSSSN
SSSSSSSSSSSSSSSSSSSPSSSSSSBSSSSSSSSBSSSSSBSSPSGSN
SSSSSSSSSSSSSSBBBSBBBSSSSSSSSSPSSSSBSSSSSBSSBBBSN
SSSSSSSSSSSSSSSSSKSSBSSSSSSSSBBBSSSBSSSSSDSBBBBSN
SSSSSSSSSSSSSSBSPSSSBSSSSSSSSSSSSSSBSSSSBBBBBBBSN
SSSSSSSSSSSSSSBBBBBBBSSSSBBSSSSSSSSBSSBBBBBBBBBSN
SSSSSSSSSSSSSSSSSSSSSSSSSSSSSSSSSSSBBSSSSSSSSSSSN
SISSPSSSSMSPSSSPSSSSSSSSSSSPSMSSPSSDSSSPSSSSSPKSN
BBBBBBBBBBBBBBBBBBBWWWWWWBBBBBBBBBBBBBBBBLLLBBBBN
BBBBBBBBBBBBBBBBBBBBBBBBBBBBBBBBBBBBBBBBBBBBBBBBN
