SSSSSSSSSSSSSSSSSSSSN
SSSSSSSSSSSSSSSSSSSSN
SSSSSSSKSSSSSSSSSSSSN
SSSSSSSSSSSSSSSSSSSDN
SSSSSSBBSSSSSSSSSSBBN
SSSSSSSSSSSSSSSSSSSSN
SSSSSSSSSSSSSBBSSSSSN
SSSSSSSSSSSSSSSSSSSSN
SSSSSSSBBSSSSSSSSSSSN
SSSSSSSSSSSSSSSSSSSSN
SSSBBSSSSSSSSSSSSBBSN
SSSSSSSSSSSSSSSSSSSSN
SSSSSSSBBSSSSBBSSSSSN
SSSSSSSSSSSSSSSSSSSSN
SSSSSSSSSSBBSSSSSSSSN
SSSSSSSSSSSSSSBBSSSSN
SSSSSSSSSSSSSSSSSSSSN
SSSSSSSSSSSBBSSSSSSSN
SSSSSSSSBBSSSSSSSSSBN
SSSSSBBSSSSSSSSSSSSDN
SISSSSSSSSSSSSSSSSSDN
BBBBBBBBBBBBBBBBBBBBN
BBBBBBBBBBBBBBBBBBBBN