SSSSSSSSSSSSSSSSSSBSN
SSSSSSSSSSSSSSSSSSBSN
SSSSSSSKSSSSSSSSSSBSN
SSSSSSSSSSSSSSSSSSDGN
SSSSSSBBSSSSSSSSSBBBN
SSSSSSSSSSBSSSSSSSSSN
SSSSSSSSSSSSSBBSSSSSN
SSSSSSSSSSSSSSSSSSSSN
SSSSSSSBBSSSSSSSSSSBN
SSSPSSSSSSSSSSSSSPSSN
SSSBBSSSSSSSSSSSSBBSN
SSSSSSSSSSSSSSSSSSSSN
SSSSSSSBBSSSSBBSSSSSN
SSSSSSSSSSSSSSSSSSSSN
SSSSSSSSSSBBSSPSSSSSN
SSSSSSSSSSSSSSBBSSSSN
SSSSSSSSSSSSSSSSSSSSN
SSSSSSSSPSSBBSSSSSSSN
SSSSSSSSBBSSSSSSSSSBN
SSSSSBBSSSSSSSSSSSSSN
SISPSSSSSPSSSPSSPSSSN
BBBBBBBBBBBBBBBBBBBBN
BBBBBBBBBBBBBBBBBBBBN